Stage 1
####
#P #
# o##
#  O#
#####
====
Stage 2
#######
#    O#
#  ####
#  #
#  ####
#   oP#
#   oO#
#######
====
Stage 3
#######
#    O#
# oo# #
# # #o#
# #P  #
#O   O#
#######
====
Stage 4
    ######
#####    #
#  O#  o #
#      # #
#  O#  # #
#O# # ooP#
#####    #
    ######
====
Stage 5
#######
#O  O #
#   # ###
#   #   #
# #o oP #
#  O#o  #
#   #   #
#########
====